11111
11C11
11111
1P111
11E11
11111