1111111111111
10E0000000001
1111111111101
1CC0001CC0101
1000101000101
1101101110101
1C0C100000101
1000101111101
1101100000001
1101110111011
100C1X0X10001
100C1XPX1C0C1
1111111111111