1111111111111111111111
1X11111111111111111111
1111111100000000PE1111
111111111CXC1111111111
1111111111C11111111111
1111111111111111111111